P C C C C C C C C C
C C C C C C C C G C
C C C C C C C C C C
C C C W W W W C C C
C C C C C C C C C C
C C C C G C C C C C
C C W C C C C W C C
C C W C C C C W C C
C C W C C C C C C C
C C C C C C C C C E
10